11111111111111111111111111111
1C0000000000000000C0000000001
10111111111101111111111111111
10111111111101111100000011111
10111111111101111111111111111
10111111111101111111111111111
10111111111101111111111111111
1P11100000C000000000000E11111
11111111111111111111111111111