1111111111111111111111111
1C00000000000E11111111111
1000000000000111111111111
1000000000000111110000001
1000000000000111110111111
1P111C00000000000000000C1
1111111111111111111111111